111111111111111
111111000111111
111100000001111
1111P00000E1111
111100000001111
1111110C0111111
111111111111111