1111111111111111111111111
11P01111CC11111E000000011
1100111100111111111110011
1100111100111111111110011
1100000000111110000000011
1111111100111110011111111
1111111100111110011111111
1111111100111110011111111
1111111100000000000000011
1111111111111111111111111